111111111111111
101100000000101
110000000P00011
100C000011E0011
101110000000011
100C10000000111
1C11100000010C1
111111111111111
