1111111111
1011000C01
1000000001
100C0011E1
1111111111
