1111111111
1011000C01
10000000P1
100C0011E1
1111111111
