1111111111
10110000C1
10000000P1
10000011E1
1111111111
