1111111111
1P11000C01
100000001
100C0011E1
1111111111
