1111111111
1P11000C01
1000000001
100C0011E1
1111110111
