1111111111
1P11000C01
1000000000
100C0011E1
1111111111
